   ,___________________________,
  /                             \
 |]            ______           [|
 |  ___                    ___   |
 |             ,     ,           |
 |]  ___       |\___/|    ___   [|
 |             |oOoOo|           |
_| ___         |ooo o|      ___  |
               | oooo|           |
_______________|_____|__________[|
_______|__________|________|_____|
       |                   |
       |/\/\/\/\/\/\/\/\/\/|